play = Play
options = Options
quit = Quit
share = Share
character = Character
record = Record
sound = Sound
language = Language
back = Back
facebook = Facebook
wpp = Whatsapp
copy = Copy Link
next = Next
chose = Chose
textAcai = Your Total Acai Collection is:
textPlay = Your Total Matches is:
nivel = Level 1
nivel2 = Level 2
nivel3 = Level 3
lose = You lose
text = Not this time, try again.
victory = Victory
textvit = Congratulation, you is the champion, keep going.
pause = Pause.
textpau = Don't give up, you will win.
tutorial = Tutorial
texttuto = Welcome to ChaGame.Collect the required amount of acai and deliver it to the correct place to pass the phase. Beware of insects.
texttuto2 = Part 2.
colect = Colect
textcole = You colect a good Acai, keep going. Good luck.
textcole2 = Part 2.
barbeiro = CAUTION
textbarbeiro = You touched on a INSECT, ​​when you find one, stay away. They are dangerous.
textbarbeiro2 = Part 2.
saude1 = Healthy
saude2 = Sick
saude3 = Very ill
confirm_menu = Are you sure you want to return to the menu?
confirm_restart = Are you sure you want to restart?

