play = Jogar
options = Outros
quit = Sair
share = Compartilhar
character = Personagem
record = Recorde
sound = Sons
language = Idioma
back = Voltar
facebook = Facebook
wpp = Whatsapp
copy = Copiar Link
next = Próximo
chose = Escolher
textAcai = Sua Coleta Total de Açaí é: 
textPlay = Seu Total de Partidas é:
nivel = Nivel 1
nivel2 = Nivel 2
nivel3 = Nivel 3
lose = Que Pena
text = Não foi dessa vez, tente novamente.
victory = Vitória
textvit = Parabéns, você é um campeão, continue assim.
pause = Pause.
textpau = Não desista, você consegue.
tutorial = Tutorial
texttuto = Bem Vindo ao ChaGame. Colete a quantidade necessária de açaí e entregue no local correto para passar de fase. Cuidado com os barbeiros.
texttuto2 = Parte 2.
colect = Coleta
textcole = Você coletou um Açaí saudável, continue coletando para entregar em locais apropriados e passar de fase. Boa sorte.
textcole2 = Parte 2.
barbeiro = CUIDADO
textbarbeiro = Você tocou em um BARBEIRO, cada vez que encontrar um você deve passar o mais longe possível, eles são perigosos e transmitem doença.
textbarbeiro2 = Parte 2.
saude1 = Saudável
saude2 = Doente
saude3 = Muito Doente
confirm_menu = Tem certeza que quer voltar ao menu?
confirm_restart = Tem certeza que quer reiniciar?


